000000000000000000000000000000000000000000000000000000000000000000000000000000000000000000000000000000000000000000000000000000000000000000000000000000
0                                                                                                                                                    0
0                                                                                    w                                                               0
0                   w                                  w                   w                                                                         0
0                                      w                                       kk                   kkkkkkkkk    kkkkkkkkkkk                         0
0                                                                             k  k    k    k        k       k         k                              0
0                      c                                                      k      kkk  kkk  w    k       k         k                              0
0                                                                       r     k       k    k        kkkkkkkkk         k                              0
0                                                                      rr     k  k                  k                 k                              0
0                                                                     rrr      kk                   k                 k                              0
0               c    kckck                                           rrrr                                                                            0
0                                      t0                           rrrrr                                                     t0                     0
0G                                     00              t0          rrrrrr            G                                        00                     0
0           d    g       d             00              00         rrrrrrr                                                     00                     0
PPPPPPPPPPPPPPPPPPPPPPPPPPPPPPPPPPPPPPPPPPPPPPPPPPPPPPPPPPPPPPPPPPPPPPPPPPPPPPPPPPPPPPPPPPPPPPPPPPPPPPPPPPPPPPPPPPPPPPPPPPPPPPPPPPPPPPPPPPPPPPPPPPPPPP
PPPPPPPPPPPPPPPPPPPPPPPPPPPPPPPPPPPPPPPPPPPPPPPPPPPPPPPPPPPPPPPPPPPPPPPPPPPPPPPPPPPPPPPPPPPPPPPPPPPPPPPPPPPPPPPPPPPPPPPPPPPPPPPPPPPPPPPPPPPPPPPPPPPPPP
PPPPPPPPPPPPPPPPPPPPPPPPPPPPPPPPPPPPPPPPPPPPPPPPPPPPPPPPPPPPPPPPPPPPPPPPPPPPPPPPPPPPPPPPPPPPPPPPPPPPPPPPPPPPPPPPPPPPPPPPPPPPPPPPPPPPPPPPPPPPPPPPPPPPPP
